[1, 0, 0, 1, 0, 0, 0, 1, 2, 3]
[2, 0, 0, 0, 0, 1, 0, 0, 1, 4]
[3, 0, 0, 0, 0, 1, 0, 0, 1, 5]
[4, 0, 0, 0, 0, 1, 0, 0, 2, 5, 6]
[5, 0, 0, 0, 1, 0, 0, 0, 3, 4, 6]
[6, 0, 1, 0, 0, 0, 1, 0, 4, 5, 7]
[7, 1, 0, 0, 0, 0, 0, 0, 6, 4, 7]
